1111111
10C0001
1000E01
100P001
1111111
