1111111111
1C00000011
1000001001
11110000C1
1P00000001
1000000001
1000100001
1000100001
1E00100001
1111111111
