111111111111
1P0000000001
100000000101
10000C010001
111111000001
100000000001
100000000001
1000C0000001
100000000E01
111111111111